ПЕРЕД СДАЧЕЙ В ПРОГРАММУ СТЕРЕТЬ!!!

Все цифры идентифицируют квадрат 10*10 пикселей

0 - пустой квадратик
1, 2, 3, 4 - координатная четверть, в которой располагается четверть точки
5, 6, 7, 8 - координатная четверть, в которой располагается четверть капсулы
9 - стена

0 0 0 0 0 0 0 0 0 0 0 0 0 0 0 0 0 0 0 0 0 0 0 0 0 0 9 9 0 0 0 0 0 0 0 0 0 0 0 0 0 0 0 0 0 0 0 0 0 0 0 0 0 0
0 4 3 4 3 4 3 4 3 4 3 4 3 4 3 4 3 4 3 4 3 4 3 4 3 0 9 9 0 4 3 4 3 4 3 4 3 4 3 4 3 4 3 4 3 4 3 4 3 4 3 4 3 0
0 1 2 1 2 1 2 1 2 1 2 1 2 1 2 1 2 1 2 1 2 1 2 1 2 0 9 9 0 1 2 1 2 1 2 1 2 1 2 1 2 1 2 1 2 1 2 1 2 1 2 1 2 0
0 4 3 0 0 0 0 0 0 0 0 4 3 0 0 0 0 0 0 0 0 0 0 4 3 0 9 9 0 4 3 0 0 0 0 0 0 0 0 0 0 4 3 0 0 0 0 0 0 0 0 4 3 0
0 1 2 0 9 9 9 9 9 9 0 1 2 0 9 9 9 9 9 9 9 9 0 1 2 0 9 9 0 1 2 0 9 9 9 9 9 9 9 9 0 1 2 0 9 9 9 9 9 9 0 1 2 0
0 4 3 0 9 9 9 9 9 9 0 4 3 0 9 9 9 9 9 9 9 9 0 4 3 0 9 9 0 4 3 0 9 9 9 9 9 9 9 9 0 4 3 0 9 9 9 9 9 9 0 4 3 0
0 1 2 0 9 9 9 9 9 9 0 1 2 0 9 9 9 9 9 9 9 9 0 1 2 0 9 9 0 1 2 0 9 9 9 9 9 9 9 9 0 1 2 0 9 9 9 9 9 9 0 1 2 0
0 8 7 0 9 9 9 9 9 9 0 4 3 0 9 9 9 9 9 9 9 9 0 4 3 0 9 9 0 4 3 0 9 9 9 9 9 9 9 9 0 4 3 0 9 9 9 9 9 9 0 8 7 0
0 5 6 0 0 0 0 0 0 0 0 1 2 0 0 0 0 0 0 0 0 0 0 1 2 0 0 0 0 1 2 0 0 0 0 0 0 0 0 0 0 1 2 0 0 0 0 0 0 0 0 5 6 0
0 4 3 4 3 4 3 4 3 4 3 4 3 4 3 4 3 4 3 4 3 4 3 4 3 4 3 4 3 4 3 4 3 4 3 4 3 4 3 4 3 4 3 4 3 4 3 4 3 4 3 4 3 0
0 1 2 1 2 1 2 1 2 1 2 1 2 1 2 1 2 1 2 1 2 1 2 1 2 1 2 1 2 1 2 1 2 1 2 1 2 1 2 1 2 1 2 1 2 1 2 1 2 1 2 1 2 0
0 4 3 0 0 0 0 0 0 0 0 4 3 0 0 0 0 4 3 0 0 0 0 0 0 0 0 0 0 0 0 0 0 0 0 4 3 0 0 0 0 4 3 0 0 0 0 0 0 0 0 4 3 0
0 1 2 0 9 9 9 9 9 9 0 1 2 0 9 9 0 1 2 0 9 9 9 9 9 9 9 9 9 9 9 9 9 9 0 1 2 0 9 9 0 1 2 0 9 9 9 9 9 9 0 1 2 0